######################
#                    #
#                    #
#                    #
#         X          #
#        ###         #
#                    #
#   ###      ###     #
#      #    #        #
#      #    #   N    #
#      #    #        #
#    S #    # S      #
#      #    #        #
#G  ####    ####     #
######################## 