######################
#                    #
#                    #
#                    #
#                    #
#        A           #
#                    #
#        #####       #
#        #           #
#   ##   #    O      #
#        #           #
#    S   #   S S     #
#        #           #
#G #######   ####### #
######################## 